K.K. Idol (Radio) - 朝日温子 / 戸高一生
Spoiler Original Mix - Hyper
Here Goes!! - 寺山善也
Faded Tone "C" - 鈴木幸太
Faded Tone "G" - 鈴木幸太
The Duel (Introduction) - Casey Edwards
Devil Trigger (Instrumental Edit) - Casey Edwards
The Duel - Casey Edwards
The Omerta - SEGA Sound Team
誰がために・改 - 庄司英徳
Fiercest Warrior ver.0 - ゆよゆっぺ / 吉田沙織
歓喜の刻 - 土橋善太
Devil Trigger (Opening Remix) - Ali Edwards
Devil Trigger (Tropical Devil Night Remix) - 前馬宏充
History of DMC - 前馬宏充
真島建設社歌 - 宇垣秀成 / 真島建設
Credit of KIWAMI - SEGA Sound Team
Ruthless Octagon - 庄司英徳
Rebellious Phase - SEGA Sound Team
Come & Get Mii (Bonus) (Original Mix) - Earn Money
我无法忘记弥彦的痛苦 - 溫柔 / 你偷了我的糖
I am Shock - Audio Highs
HouGe-Kid Singing in Walmart（HouGe remix） - LianCs
お前も糖人形にしてやろうか！ - Audio Highs
てめーらァ！ブッた斬る！！ - Audio Highs
Pump - Valentino Khan
Pitchforks & Fire - Dr. Ozi
NARUTO Main Theme (Samuel Sun bootleg) - Samuel Sun
宇智波佐助 - SHEKINAH
只要有树叶飞舞的地方,火就会燃烧 - 溫柔 / 你偷了我的糖
ɢᴀᴀʀᴀ - ᵇᵅᵖᵎ
高梨康治 - 暗潮（MyT1aN Remix) - MyT1aN
自來也豪傑物語 - emoshinobi
F-ZERO メドレー (F-ZERO) - 光吉猛修
Ⓖ ⓞ ⓛ ⓓ ⓔ ⓝ Ⓗ ⓘ ⓣ ⓢ - Grisfx
ｓａｉｋａ - cight
MADARA vs NARUTO - 高梨康治
my friend - NKOHA
儀礼 (Brownode Bootleg) - Brownode
巨大要塞、発進!! - 岩崎文紀
作戦開始 ~襲われる村~ - 田中公平
ゲルドの谷 - 近藤浩治
ゼルダ姫のテーマ - 近藤浩治
Ground Stage BGM - 近藤浩治
地上BGM (スーパーマリオブラザーズ) - 近藤浩治
アスレチックBGM (スーパーマリオブラザーズ3) - 近藤浩治
迷いの森 - 近藤浩治
Lost Woods - Will & Tim
The Legend of Zelda (ゼルダの伝説) - 近藤浩治
Tiger! Tiger! - 清田愛未
One Night in Arabia - Go Go Girls
Propaganda - 東京混声合唱団
云宫迅音 - 许镜清
杨戬擒悟空 - 许镜清
Reign - 吉田真理
Archnemesis - 庄司英徳
Firelight - 庄司英徳
閻魔の誓い - 庄司英徳
For Buddy - Wall5 Project
tusk - 庄司英徳
殉教者 - 高梨康治
Brave Love,TIGA (Brass Solo Version) <M-8> - 矢野立美
唖然呆然 - 福田有理
With Vengeance - 庄司英徳
Destiny of the Cats - POPHOLIC
We're Long Hua Expedition - 烏屋茶房
Fever ☆ Time - POPHOLIC
Trouble Shooting Star - 土橋善太
One-Eyed Slugger - 庄司英徳
To be prepared・・・ - 吉田沙織
Misery Comes On Beat - 庄司英徳
Receive You 〜Tech Trance Arrange〜 - 庄司英徳
Receive You The Subtype - 庄司英徳
Ignite Your Spirit - SEGA Sound Team
Make You Free - 松崎泰之 / 渡辺博昭
One-Eyed Assassin - 庄司英徳
Glorious Memories - SEGA Sound Team
Money Makes Money - 小林義司
Try to have some fun for me !! - 小泉真由美
La-Di-Da - 稲毛謙介
Crash Addiction - 庄司英徳
Get Them - 庄司英徳
Two Dragons - 庄司英徳
Force Addiction - 庄司英徳
怨魔の契り - 庄司英徳
new dimension - Force of Nature
dry - TSUTCHIE
breeezin' - TSUTCHIE
sneak chamber - Force of Nature
the long way of drums - Force of Nature
sanctuary ship - Nujabes
Counting Stars - DJ Vital Force
aruarian dance - Nujabes
Tank! - 菅野よう子
The Space Between Two World - Nujabes / Fat Jon
judgment on - Force of Nature
sincerely - TSUTCHIE
pretending to… - TSUTCHIE
raw material - TSUTCHIE
loading zone - Force of Nature
mist - Force of Nature
vagrancy - Force of Nature
Strobe - deadmau5
Let Go - deadmau5 / Grabbitz
Raise Your Weapon - deadmau5
Professional Griefers - deadmau5 / Gerard Way
Moar Ghosts 'n' Stuff - deadmau5
Monophobia - deadmau5 / Rob Swire
The Veldt (8 Minute Edit) - deadmau5 / Chris James
ったく仕方ねぇなぁ、いくぜ！！ - Audio Highs
まだ割れてねーじゃねーか、しゃぼん玉 - Audio Highs
鉄を叩きながら　てめーの魂を叩き上げろ - Audio Highs
Polaris - deadmau5
Battle 3 - deadmau5
Startup 1 - deadmau5
Startup 3 - deadmau5
Slip (REZZ ReVision) - Rezz / deadmau5
So Nice - Alexander Lewis / KRANE
Soviet Connection — The Theme from Grand Theft Auto IV - Michael Hunter
A Samurai's Death - RickO James
Shadowtask - PYLOT
4BLM_101_Chokkaku - 鷺巣詩郎
疾走 - 菅野祐悟
PROJECT.D I - V.A.
RED SUNS (高橋兄弟のテーマ) - 勝又隆一
杜王町Radio - 长谷川大祐 / 菅野祐悟
Awake - 岩崎琢
wet my scales - 宮崎誠
Spaceship - 宮崎誠
The cyborg fights - 宮崎誠
Get It All - Popeska / MYRNE / Emily Hendrix
Rebound - Andrew Luce / MYRNE
Slipping Away (Myrne Remix) - MYRNE / Cheney / BH
Watchmaker (Original Mix) - MYRNE
Afterdark - MYRNE / Aviella
Confessions - MYRNE / Cozi Zuehlsdorff
HUMBLE. (SKRILLEX REMIX) - Skrillex / Kendrick Lamar
Nothing Can Be Explained (inst ver.) - 鷺巣詩郎
Looking For A Star (Havok Roth & SWRVN Remix) - Havok Roth / XXXTENTACION / SWRVN
Seven Nation Army - Johan Soderqvist / Patrik Andrén
Teeth - painboisevket
Look At Me! (Vargo Remix) - vargo. / XXXTENTACION
Oops (Marshmello Remix & LAUX Remake) - Martin Garrix / Marshmello / Laux
SuMmeR - Marshmello
Alone (Streex Remake) - Streex / Marshmello
Let Me Love You (Marshmello Remix) - DJ Snake / Justin Bieber / Marshmello
Twinbow - Slushii / Marshmello
Alarm (Marshmello Remix) - Marshmello / Anne-Marie
Mask Off (Marshmello Remix) - Future / Marshmello
Maad City (Benzi TRUTH Edit) - Benzi / Kendrick Lamar / Graves
Parallel Lines - DVBBS / CMC$ / Happy Sometimes
Dreams (Tiësto's AFTR:HRS Remix) - Tiësto / ReauBeau / Snavs
Aural Psynapse - deadmau5
Move for Me (Hex Cougar Remix) - Hex Cougar / Kaskade / deadmau5
4ware - deadmau5
Midas' Heel - deadmau5
Pets - deadmau5
Still D.R.E (Instrumental Version) - Dr. Dre / Snoop Dogg
Surface - Aero Chord
I WaNt U To KnOw (marshmello Remix) - Marshmello / Zedd / Selena Gomez
Magic - Jauz / Marshmello
Show You - Marshmello
Divinity - Porter Robinson / Amy Millan
Shelter - Porter Robinson / Madeon
Breathless - Frection
Out of My System - Youngr
home - morgxn
I Still Wait For You (Nolan van Lith x Felix Palmqvist Remix) - Nolan Van Lith / XYLØ / Felix Palmqvist
Theme From San Andreas - Michael Hunter
Welcome To Los Santos - Oh No / Tangerine Dream / Woody Jackson / The Alchemist
「英雄の証」(Hige Driver Remix) - ヒゲドライバー
idk (prod. no will) - bbno$
Beats Knockin - Jack Ü / Fly Boi Keno
my self (prod. Alnath) - bbno$
Barbary Lions - Anti-General / Bass Hoodie
Shikaku - Anti-General
Black Diablos - Anti-General
BOOM - Tiësto / Sevenn
You - SIROJ / Nelson Clark
All Time Low - Jon Bellion / Stormzy
Club Action (Smookie Illson Bootleg) - Yo Majesty / Smookie Illson
Killa (Slushii Remix) - Slushii / Wiwek / Skrillex / Elliphant
Hero (feat. Christina Perri) - Cash Cash / Christina Perri
Ease My Mind (Jai Wolf Remix) - Skrillex / Niki & The Dove / Jai Wolf
Cold (Sak Noel Remix) - Maroon 5 / Future / Sak Noel
Hardtronik (Original Mix) - Sergio Mauri
Polyphon (Original Mix) - Kura
Helicopter (Original Mix) - Martin Garrix / Firebeatz
Show Me (Original Mix) - Me & My Toothbrush
Bomb a Drop (Radio Edit) - Garmiani
Bang Bang (instrumental) - Dr. Dre
Moon of Pejeng - Instant Party! / Breaux
Beauty - Lexxmatiq / Matstubs
Fresh Eyes (Grey Remix) - Grey / Andy Grammer
Chasing Colors - Marshmello / Noah Cyrus / Ookay
Moving On - Marshmello
In My Head - Virtual Riot / PRXZM
Jungle Bae (Jack Ü VIP Edit) - Jack Ü / Bunji Garlin / MX Prime
Chicken Soup - Skrillex / Habstrakt
Ignite (Instrumental) - Alan Walker / K-391
Insanity (Original Mix) - Dimitri Vegas & Like Mike / Blasterjaxx
Revelation (feat. HALIENE) - Blasterjaxx / HALIENE
Heartbreak (Extended Mix) - Blasterjaxx
Ghost in the Machine (feat. Jonathan Mendelsohn) - Blasterjaxx / MOTi / Jonathan Mendelsohn
Bowser - W&W / Blasterjaxx
Soldier (Extended Mix) - Blasterjaxx / Breathe Carolina
Recess (with Kill The Noise, Fatman Scoop, and Michael Angelakos) - Skrillex
Do It (Extended Mix) - Turbotronic
Black Horse - JumoDaddy
+1 (Radio Edit) - Martin Solveig / Sam White
Unusual Suspects - Jameston Thieves / Krumm
Pulse Fiction - Culture Code
My Friend (Original Mix) - Quba
雪の詠女 (Instrumental VIP) - Anti-General
熊猫人永不为奴 - Panta.Q 郭曲
Drip Drop (feat. Yazz and Serayah McNeill) - Yazz / Empire Cast
Shootin Stars - Aero Chord / DDARK
Call Waiting - Okami
Stoopid Rich - Crankdat / TITUS / Havok Roth
Drink Over You - T-Mass / Y.A.S.
The D Machine (Original Mix) - Croatia Squad
Silent(Club Mix) - Paris & Simo / Gabrielle Ross
Set My Heart On Fire - Pawl
Closer - Lemâitre
Unfaithful - NtrlTaste
Dill the Noise - Dillon Francis
Supernova - Laszlo
Need You (D!avolo Remix) - D!avolo / Ember Island
Need You - Dillon Francis / NGHTMRE
Except For Us - Austin Mahone
WHO YOU WIT - ZOOLY
Holidays (Radio Edit) - Remady / Manu-L
Closer (Crankdat Re-Crank) - Crankdat / The Chainsmokers / Halsey
Move Your Body (Alan Walker Remix) - Alan Walker / Sia
Nekozilla - Different Heaven
One Here Comes The Two - Tropkillaz
Bullseye - KDrew
Rubik - Distrion / Electro-Light
All We Know (Venera & Rick Derra Flip) - Rick Derra / Venera / The Chainsmokers
Vision - Elektronomia
Summer Air - ItaloBrothers
Anywhere I Go - Vicetone
Vicious Girl - CALVO
Nova (Original Mix) - Dimitri Vegas & Like Mike / Felguk / Tujamo
Frontier - Doctor Vox
Boardwalk - G-REX / Tuslo / Willy P
Echo (Original Mix) - POLINA / Pep & Rash
All We Know - The Chainsmokers / Phoebe Ryan
Five Voices (3LAU Mashup) - 3LAU / Calvin Harris / Clean Bandit / Jess Glynne / Phoebe Ryan / Cash Cash / Tiësto / Tritonal
Tomorrowland 2015 Mix - Dimitri Vegas & Like Mike
Like A G6 - Far East Movement / The Cataracs / DEV
Thinking About You (Hardwell & Kaaze Festival Mix) - Hardwell / KAAZE / Jay Sean
YearMix 2015 - NEXU
Aftershock (Justin Caruso Remix). - Justin Caruso
В мире где ты и я - MΣ$†ΛMN ΣKCПØNΛ†
Light It Up - CALVO / Noubya
High On You - EDX
Thinking About You - Hardwell / Jay Sean
Let Me Love You (Tiesto's Aftr:Hrs Mix) - DJ Snake / Justin Bieber / Tiësto
My Way (Tiësto Remix) - Calvin Harris / Tiësto
I Want You - Tiësto / Mike Williams
KeEp iT MeLLo - Marshmello / Omar LinX
Wizard - Martin Garrix / Jay Hardway
Apollo (Original Mix) - Hardwell / Amba Shepherd
It's Strange - Louis The Child / K.Flay
Feel So Close (Radio Edit) - Calvin Harris
Keep Pushin' (feat. Inaya Day) [Extended Mix] - Tujamo / Inaya Day
Ritual (Original Mix) - Marshmello / Wrabel
Freal Luv (feat. Chanyeol & Tinashe) - Far East Movement / Marshmello
Alone - Marshmello
What We Started - Don Diablo / Steve Aoki / Lush & Simon / BullySongs
Cutting Shapes (Extended Mix) - Don Diablo
Trndsttr (feat. M. Maggie) (Lucian Remix) - Black Coast / M. Maggie
Karate - R3HAB / KSHMR
Miss You - SOLBOI
Scarred Heart - Vexaic
No Heroes (Original Mix) - Firebeatz / KSHMR / Luciana
Nova - Breathing Heavily
TDCU - G-REX / Felmax
Bliss - Daveed
Steal Your Heart (feat. Lenachka) [Radio Mix] - BRKLYN / Lenachka
OG Purp - Tha Trickaz / Creaky Jackals
#SELFIE (Club Mix) - The Chainsmokers
Encore - Zagor
Confusion - Schaaka
酔っぱらい - NKOHA
☂ - COSMASTLY
向 - Howie Lee
Bubblegum (Tropkillaz Remix) - Jackal / CRNKN
Sunday Morning - Evil Needle
Hideho - Tropkillaz
Ball So Hard - Hucci & Stooki Sound
Ten Thousand To Flight (inst.) - Elyonbeats
Sahara - DJ Snake / Skrillex
Existence - Vexaic
Almost - Saje
Summer's Day - jinsang
Make A Banger - Medasin
added to all minus none shared by everything multiplied in abundance - MISOGI
Lightbreaker - Panda Eyes
Brightest Stars - Spire
Eventide - Nylon
Romance - NoxiK
De$ert - Badass & Dandy
Ball So Hard VIP - Hucci x Stooki Sound
Infinite Daps - Baauer / RL Grime
Flame - Antiserum / Mayhem
Worth It (Reunify vs. Kris Maydak vs. Danyka Nadeau) [feat. Danyka Nadeau] [Radio Mix] - Danyka Nadeau / Kris Maydak / Reunify
NEW REIGN - Hounds / JRaB
Ask About Me - Luke Da Duke
Lost (Extended Mix) - Sander van Doorn / MOTi
Neon Rainbow - Rameses B / Anna Yvette
Strong (Extended Mix) - R3HAB / KSHMR
Wildcard (Extended Mix) - KSHMR / Sidnie Tipton
We Were Young - DVBBS
Beautiful World (Original Mix) - Blasterjaxx / DBSTF / Ryder
Tonight (Extended Mix) - Don Diablo
Sellout - Imprintafter
人間地獄 - Anti-General
凍土 - Anti-General
Tale - Lexxmatiq / Sloth Syndrome
No Gravity - Thieves / The Lazy Boyz
Sneaky - TroyBoi / Grandtheft
Oops - Martin Garrix
Game Set - Shash'U
Infected - Tiësto / Jauz
When The Earth Goes Dark - STARLYTE / Brenton Mattheus
Silence (Bodybangers Remix) - Bodybangers / Oli Geir / Aic
Beautiful Things - Rivaldy
Now Or Never  (Chris Barnhart Remix) - Chris Barnhart
Waterfall (Kozoro Remix) - Skorge / Kozoro
Say Yeah (Original Mix) - Breaktrapper
Drift Away - Spectrum
52 Weeks - AK
Solar Wind - Yakuro
Feel That - Kronic / Raven Felix
ハル - EST
Peppa Pig - Hugekilla
Explorers - Hinkik
Taking Over (ft. Miyoki) - Rob Gasser / Miyoki
Traveler - Event Horizon
Sugar Kisses - NGC 3.14
枕元にゴースト - Aiobahn / Yunomi
Entorevolution - Bernis
Memories - Sappheiros
Tonight - Metio
Cloud Ten - Fareoh
Forsaken - AIKA / NGC 3.14 / 猫村いろは
Follow Me (Vhana Remix) - Hardwell / Jason Derulo / Vhana
Something In The Way You Move (Said The Sky Remix) - Said The Sky / Ellie Goulding
GONNA DIE - Marcelo
Trip - Artegon
Power - 徐梦圆 / 负离子
Firebird - The NEF Project
Sixteen - FEWZ
Revolution - Ahxello
Bless - Hucci / Gravez
Downfall - TRIADS
atrocity w/ LYNX - 罪૨¡ɱ
Hotdamn! - Tropkillaz
September - Kev
El Chapo (Fawks Flip) - Fawks / The Game / Skrillex
GoGo! - Baauer
Gladiator (Felmax Remix) - UZ / Felmax
Pay For What (Alexander Lewis Trombone Flip) - Alexander Lewis / Mr. Carmack
QUESTIONMARK - Zagor
I Love Ralph Caps - Lil Cliff
Yaow! - Baauer
Till The AM - TroyBoi
Two Step - Chime / Lord Swan3x
Sunset - Canvai
… - Yung Castor
Sweet Harmony (Original Mix) - DubVision
Legends (Extended Mix) - MOTi / Alpharock
Stardust - Jay Hardway
Triple Six - Curbi
Fcukin Beats (Original Mix) - Laidback Luke / twoloud
Novell (Original Mix) - Nicky Romero
Heatwave (Extended Version) - Robin Schulz / Akon
Pilot (Extended Mix) - Julian Jordan
Dharma (Extended Mix) - Headhunterz / KSHMR
Move To The Sound - Afrojack / Laidback Luke / Hawkboy
Space Sheep - Oliver Heldens / Chocolate Puma
Alarm (Extended Mix) - Olly James / R3SPAWN
Inyathi (Extended Mix) - GAIA
Blackout - Pegboard Nerds
Artifact - Dyro
Outside Calavera (Wavers Mashup) - Wavers / Calvin Harris / Hardwell / Kura
Burning Love - Axlance
We Were Infinite - Outwild
Murda - Snavs / Fabian Mazur
Zombie - Vinai
Live The Night (Extended Mix) - W&W / Hardwell / Lil Jon
8Fifty (Extended Mix) - Hardwell / Thomas Newson
All About That Bass (Ice Creamz Remix) - Meghan Trainor / Ice Creamz
Far Away - Wisp X / LilyCloud
Liquid (Original Mix) - R3AKTIV
Kids - Jerry Folk
Never Giving Up (Extended Mix) - Tom Swoon
Savage - Borgeous / Lil Jon / Riggi & Piros
Live Like A Warrior (Richello Remix) - Matisyahu
Believe (Original Mix) - ThimLife / Marque Aurel / VANESSA
Fresh Off The Grill - Dan Farber
Alive (Original Mix) - Krewella
Nevada - Vicetone / Cozi Zuehlsdorff
Heights - Vaydr
Cold Blooded Love - Goblins from Mars / Krista Marina
GANGSTA(ZAGOR REWORK) - Zagor / OZZIE
You & Me (Flume Remix) - Disclosure
Meridian - su na
Sensei - TroyBoi
Bad Bitches (Deorro VIP Edit) - Deorro / Quintino
Attention - OZZIE
Gangsta - OZZIE
Slip - OZZIE
The Signal - OZZIE
6 - OZZIE
Earl Grey - NGC 3.14 / Maiko Hakurei
OMG - $hinTo
Bubblin' - Fabian Mazur
Hermetico (Freedo's Dirty Talk Remix) - Balkan Beat Box
essex (Surface EP out soon) - su na
Ibaraki - Biz
Moon Gardens - TroyBoi
❁ - Vader Roze
看见山! - Howie Lee
Knife - Flannel. / William
Survival Waves (Original Mix) - Quok
Yoyo Toyko (Prod. Slight) - Slight / bbno$
Shihan - DENCHO / RDLT
Off To Tokyo - Fzpz
Japanese Witch Trap - Yoshimi
Matcha 抹茶 - VON GOLD
Harbinger - Shinigami
Ronin of the crypt - Shinigami
Homage To G - KRANE
Mind's End - Marcus D
芸者 × Geisha - DENCHO
Tired - DENCHO
Ballin' In Bali - Avatar Darko
Super Saiyan - Cosmic
K i n k a k u j i 金閣寺 - Koyö
HARAKIRI 切腹 - Kdn ☥
Hyakkiyakou - Anti-General
Zheng - Coubo
Mambo - Tropkillaz
Heart Of Glass - MRVLZ
Earth & Sky - Virtual Riot
Aftershock - NGHTMRE / Boombox Cartel
Dum Dee Dum (NGHTMRE Remix) - NGHTMRE / Keys N Krates
Superstar - Pegboard Nerds / NGHTMRE / Krewella
Burn (Let Your Mind Go) [feat. Luciana] [Extended Mix] - KSHMR / DallasK / Luciana
Nuclear (Album Version) - Zomboy
Miles Away - Zomboy
Swoop - ETC!ETC! / Diplo / Brillz
Sakura - Kinnon
Take It High - GRIZ / Ivan Neville
Like A B***h (Extended Mix) - Zomboy
Tell Me - su na / Ravyn Lenae
Lights Out - OZZIE
Trap Wars (The Imperial March) - P.A.F.F.
Veyron (feat. Mahoy) - Gameface Official / Mahoy
Magellan - UZ
How Deep Is Your Love (DJ Snake Remix) - DJ Snake / Disciples / Ina Wroldsen / Calvin Harris
Goons - GTA
Propaganda (Original Mix) - DJ Snake
Lambo(NextRO & Defox Remix) - NextRO / Gameface / DEFOX
Empire - NextRO / King Kong Music
Easy - Son Lux
We've Never Met but Can We Have a Cup of Coffee or something - In Love With A Ghost
New Ways - Ranji / Tezla
O.G - TroyBoi
Out Of This Ili (A$AP Rocky X Troyboi) - AVSTIN JAMES / A$AP Rocky / TroyBoi
ARABIA - V.F.M.style
Tears (Wideboys Remix) - Clean Bandit / Louisa Johnson / Wideboys
Getting Close (Metyou Remix) - Metyou
Imagination - Elektronomia
Lean On Olympus (Wavers Mashup) - Wavers / Major Lazer / Maestro Harrell
Wasted Love - TroyBoi / Sam Sure
Random Acapella Contest (Original Mix) - Gameface / BLVCK
To My Soul - Jerry Folk
Forbidden Voices - Martin Garrix
Satellite(Original Mix) - Riva Elegance
End of Time - Jim Yosef / Brenton Mattheus
Late at Night (Dub) - Betoko / Louie Fresco / Fritz Helder
Chocolate Cat - Feraz
Still Young (Original Mix) - Adventurer / Chawe
Let Me Tell You Something - Grandtheft / Jackal
Negative ROI - Boeboe
Road To Heaven - Martin Vide
You Know - Jerry Folk / ELOQ
Trap shit V22 - UZ
Sex Apeal [Max Farenthide Edit] - Bueno Clinic
Grimey Thirsty (Instant Party! Remix) - Instant Party! / Far East Movement / YG
Remember - TroyBoi
W2L (Welcome To London) - TroyBoi / Stooki Sound
On My Own - TroyBoi / Nefera
Do You? - TroyBoi
Afterhours (feat. Diplo & Nina Sky) - TroyBoi / Diplo / Nina Sky
See Me - OZZIE
Enough - Beshken
Gucci Bandana (Prod.JRaB) - TheBakeFactory
Raveology - DVBBS / Vinai
Roses - The Chainsmokers / ROZES
#SELFIE (Instrumental Mix) - The Chainsmokers
So Bad (EDWYNN x TIKAL x Spirix Remix) - EDWYNN X TIKAL / Brandon Skeie / Spirix
The La La La Remix - Gamper & Dadoni
Here With You - Asher Monroe
Runaway (U & I) (Extended Mix) - Galantis
LCA (Halfway House Edit) - GTA
Cypher - 3ASiC
Feels - Giraffage
Ratchet - Borgore
Lean On - Major Lazer / MØ / DJ Snake
Certified Gz - Crizzly
4 In The Morning - Yellow Claw
Call Me - StayLoose / MYRNE
Double Tap - Jordin Sparks / 2 Chainz
We No Speak Americano (Original Version) - Yolanda Be Cool / DCup
QAEDA - Irregular / iris
Numb - Nick Jonas
Phresh Out The Runway - Rihanna
Out The Speakers - A-Trak / Milo / Otis / Rich Kidz
Islands, Waves, Caves, & Skies - Pusher
Souls - TroyBoi
Blame (R3HAB Trap Remix) - Calvin Harris / John Newman
Misbehave (Diamond Pistols Remix) - SHIFT K3Y / Born Dirty
Runaway (U & I) [Dillon Francis Remix] - Galantis / Dillon Francis
Bang The Underground - DJ Snake
ili - TroyBoi
Destruktion - Laxx / Brillz
Black Hole - SkisM / Trampa
Vega - Graves / Tails
TOYO (Feat. Paul Maxwell) - J.u.D.
Spaceships - AREA21
Exodus (Major Lazer X P.A.F.F. Remix) - Major Lazer / Bunji Garlin / P.A.F.F.
Worldstar - STF
Be With You - Giraffage
Kingdom - OZZIE
STREET - NGHTMRE
Close 2 Me - Giraffage
Immortals (Remix) - Fall Out Boy / Black Thought
Ganjaman - Alfons
Range Rover - PAZ
Young and beautiful - mAjorHon
Bittersweet (Conro Remix) - Dyro / Conro / Envy Monroe
Champion Sound (Mixshow Edit) - Freedo
Bird Machine - DJ Snake
You Found Me (feat. Courtney Jenaé) [Extended Mix] - Blasterjaxx / Courtney Jenaé
Booty Bounce (Original Mix) - Tujamo
Never Leave (Extended Mix) - DVBBS
Live Your Life (Original Mix) - Headhunterz / Crystal Lake
Pitch Black (Extended Mix) - Vicetone
On My Mind - Don Diablo
Raveheart - DVBBS
The Wave (feat. Harrison) - Vinai / Harrison
Shotgun - Yellow Claw / Rochelle
Ecuador (Extended Mix) - Sash! / Olly James
Invincible (Original Mix) - Borgeous / Julia Michaels
Blowfish - Quintino / Kenneth G
Revolution (Vocal Mix) - Ummet Ozcan / R3HAB / NERVO
Rock N' Roll - Lexxmatiq
Hello, Hello - Mari Ferrari
Android Twerk - Bosiyaw
Like I Would (Tom Budin Remix) - Tom Budin / ZAYN
Next Episode (CAKEDUP tree-mix) - Caked Up
40'z - ZOOLY
New Thang - Redfoo
All I Wanna Do - Martin Jensen
Breathe - E M B R Z
Summer (Diplo & Grandtheft Remix) - Calvin Harris / Diplo / Grandtheft
Hagakure - Boot / TZR
7/11 (Skrillex & Diplo's Jack Ü Remix) - Jack Ü / Beyoncé
How Else - Steve Aoki / Rich The Kid / iLoveMakonnen
Bring The Madness (Aero Chord Remix) - Excision / Pegboard Nerds / Aero Chord / Mayor Apeshit
Caviar - Instant Party! / QUIX
Legends - Razihel / TeamMate
Titans - Razihel / Aero Chord
Kingpin (feat. Big Sean) (Salva Remix) - RL Grime / Big Sean / Salva
Dirty Laundry (TWRK Remix) - TWRK / Blackbear
That Paper - Lady Bee / Feliciana
Bring The Trumpets (Original Mix) - Lady Bee
Fools Paradise - Dirtcaps / Rochelle
Hustle Hard - Dirtyphonics / UZ / Trinidad Jame$
Secrets (Diplo Remix) - Diplo / Vassy / Tiësto / KSHMR
Sing Me to Sleep - Alan Walker / Iselin Solheim
Memories Of You - Zeraphym 六翼使徒
Don't Fake The Funk. - Funklow
All Falls Down (Shanahan Remix) - SHANAHAN / Speed Limits / Jus Jack
FIGHT - Zagor
ROLLIN - ZOOLY
Animal Style - Jackal
Riptide - Bishu
Static - Bosstone
When I Look At You (Ookay Trap Remix) - Emalkay
Smoke That - Dan Farber
Flip - Millions Like Us
Jumpers - Quba
Beat It Up - Louisiana Jones
Moctezuma II - I.V.
ME GUSTA TU SUAJ - Lory Money / BA$$ILONES
Aerosol Can (Mr. Carmack Remix) - Mr. Carmack
Loud Strings (Original Mix) - Tomsize / Simeon
Close My Eyes 2.0 - K Theory
Skyfall (RL Grime & Salva Remix) - RL Grime / Travis Scott / Young Thug / Salva
HUSH - Biometrix / Charli Brix
Fooled - Buku
Eastern Swing - Eliminate
Atshaan - DJ Lexxmatiq / Beau Di Angelo
Frazzeld (Trapmasters Remix) - The OriGinALz
Don't Want It - Brenmar / Sayyi
Dollar Sines - KRANE
El Mariachi (Extended Mix) - Bassjackers / Jay Hardway
CLICK - Haterade x Contrvbvnd
Prison Riot - Flosstradamus / GTA / Lil Jon
Threat - Laxx
Step Three - Laxx
Get Em Up (Original Mix) - LVX
Dancehall Soldier - Yellow Claw / Beenie Man
Here We Go Now (Original Mix) - Snavs / Tropkillaz / Fatman Scoop
Visionary - Rain Man / Sirah
Bass Shot - Benasis
Loko (Jai Wolf Remix) - Lookas
Genesis - Lookas
Samurai - Lookas
Movin' Bass (GTA Remix) - Rick Ross / JAY-Z
Where Are Ü Now (with Justin Bieber) [Marshmello Remix] [feat. Justin Bieber] - Jack Ü / Justin Bieber / Marshmello
Thirst (Original Mix) - Fademan / Oleg Kvasha
Voices (Trap Mix) - Mendus
Get You - Simeon
Booty Down (Original Mix) - Dirtcaps / Raynor Bruges
BLVDE (Original Mix) - Aero Chord
Karate Kid (VIP Mix) - Eliminate / Armanni Reign
Make Some Noise (GLOWINTHEDARK & Wax Motif Trap Remix) - Junxterjack / Chuckie / Glowinthedark / Wax Motif
Rattlesnake (Original Mix) - Foxsky
Ambush - Our Time
Hu$tle - Antiserum / Mayhem
Jump - Tomsize / Simeon
w a s a b i f l a v o r e d l e a n - K H E N S U
NOISE - Sokos
Stardust Sphere - TSUKASA
Clouds - Metio
Never Ending Rain - L3V3LS
Must Be The Feeling (Radio Edit) - NERO
Knock Out (Original Mix) - Dualive
Eclipse - Dave Erpson / TFLM
Black (From The Waist Down) - Jason Rene / Albert Kick
Hurricane (Arty Remix) - ARTY / Halsey
Restore - NGC 3.14
Spirit (Radio Edit) - Krayzius
LA LA LAND (Extended Mix) - DVBBS / Shaun Frank / Delaney Jane
I Fink U Freeky (God's Death Trap Remix) - Die Antwoord / God
Temple - Baauer / M.I.A. / G-DRAGON
Roll With Me - Max Styler / Kyle Hughes
Beggars - Krewella / DISKORD
Temple (Prismo Remix) - Prismo / M.I.A. / G-DRAGON / Baauer
Haters (Original Mix) - NextRO
24k - DVBBS
Vigorous (Original Mix) - DAO
Fire - Aventry
Woo (Original Mix) - D.O.D
Another Day - Kestutis K
That's How You Know(Teflo Tropical Remix) - TEFlo / Nico & Vinz / Bebe Rexha
With You (With You) - Metio
Mac n' Cheese (live mashup) - Shawn Wasabi
Believe (B3NJAMIN Remix) - B3NJAMIN / Thomas Gold / Bright Lights
Eutopia - Yooh
O2 (Original Mix) - TIJIN
Bacon n Eggs - FEWZ
All The Way (Original Mix) - Marcus Santoro
Away - Class-x
Mine - Tincup
Awesome - Valcos
Keep It Goin' (Original Mix) - D!RTY PALM
Miracle (Radio Edit) - Peter Luts / Levi
Force - Alan Walker
Marble Soda - Shawn Wasabi
My Wish - Vinze / Axis
A World Away - Resistance
Close To You - Aventry / LoaX / Rosendale
Journey Through The Sea - L3V3LS
Times Gettin' Hard (Radio Version) - Coone / K19
Shower (D!avolo Remix) - D!avolo / Becky G
The Day Will Come - Vinze / Nathan Brumley
Go Down (Radio Edit) - Alchemist Project
Spectrum - Sup3rgo
Azitate - void
Evolving - Ahrix
Avenue - Dave Erpson
Soundclash - TroyBoi / Flosstradamus
Painting Greys - Emmit Fenn
Dedication - void
Surf - Tingo
Sepia - SHIKI
Reflections - Kontinuum
Frozen World - 無力P
Shinto - EnV
SEPIA (void's Balearic Remix) - void
Memory Of A Melody - SmK
コイイロベリー - Snail's House
Beam(Original) - Mako
Break My Fall - NIXALE / STARLYTE
Satisfied (Sneiks Festival Remix) - Sneiks / Showtek / Vassy
Anima - xi
Open Your Eye - L3V3LS
Uncommon Journey (Original Mix) - Fathoms / MaHi
Free - Polarr
COSMOS(Extended) - BlackY's BEATFLOOR
Behind The Sunset (Original Mix) - Shingo Nakamura
R.I.O. Megamix (Continuous DJ Mix) - R.I.O.
Heaven - Starix​ / Dogena
Clear Skies - Amasi
Smoke Filled Room (Kevin Easy Remix) - Kevin Easy / Mako
Childhood - Denis Neve
Kick Some Ass (Original Edit) - Turbotronic
Paradise (Original Mix) - Amasi
Never Be Alone - TheFatRat
Return - Axel Wernberg / Ennex / Linne
Lone Walker - Nyte
Paladin - EnV
Polaris (NGC 3.14 Remix) - NGC 3.14 / Jun Kuroda
Life - Tobu
Into The Strong Light (Wavers Mashup) - Wavers / R3HAB / KSHMR / Sick Individuals / DBSTF
Hymn for the Weekend (BOXINBOX & LIONSIZE Remix) - Boxinbox & Lionsize
Pluto (Drop Tower Remix) - Drop Tower / Nyte
Move Up (Lost Gravity) - Mr. Polska
Eclipse - Jim Yosef
Wouldn't Change It - Halvorsen
Visionary - CelDro
My Angel - Multex
ゾンビメイカー - ATOLS / 初音ミク
Devotion - Amasi
Fly - Andelon
California - Marc May
Shots & Squats - Vigiland / Tham Sway
End of Summer (Axlance Remix) - Janji / Axlance / T.R.
Good Girls - Sonny Banks
Bring Back the Summer (feat. OLY) - Rain Man / Oly
In Heaven - Pilton
What Love Is - L3V3LS
Lands (Original Mix) - Vicktor / Amasi
Take Me Hand - DAISHI DANCE / Cécile Corbel
ココロトラベル - Snail's House
Never Let Go(Extended Mix) - Culture Code / eLex
Three Of Us - OceansWhoLied
Komorebi - m-taku
Atlas - Nyte
The Spirit Of Light (Original Mix) - Timekeeperz / Anklebreaker
Summertime - K-391
No Place Like Home - Electus
Dawn Of Time - Richard Schrieber
Sunburst - Tobu / Itro
Sirin - Class-x
Bring Back The Summer (Not Your Dope Remix) - Not Your Dope / Rain Man / Oly
In Colour - Articulate / Addictia
Elysia's Heart - Aether / Enzalla
Free (Radio Edit) - Shockwave
너를 기억하다 - July
Flight of the Soul - Stive Morgan
Unwind - Flipside
River Flows in You - Krisu
Pneumatic Tokyo - EnV
Away From Here (Valentin's 'Away From Her' Mix) - Valentin
Fragments - Sappheiros
Autumn's Wind - Joohyun Gil
Ocean Floor (Original Mix) - ZENI
Who's Lovin' You - October
Sunset Over Emst - Roald Velden
The Light Inside You (Original Mix) - Avi8
Silent express - 出羽良彰
Fell for U - Noicybino
Awake - WRLD / Colordrive
Voyage - NGC 3.14
Tiny Heart，Tiny Love - DJ Soviet
夏夜 - 四季音色
Heaven (Radio Edit) - Gson & Abley / Amasi
Highland - Canvai
Freeze - Stahl! / Kadenza
Vivant - Kvítek
My Imotion (Original Mix) - Sashoook
水面の満月 - 神乃木製作所
Drop - 徐梦圆
My Soul - July
Candy★Night - DJ Soviet
Astral - Scott Mcguigan / NXY
Inspiration (Original Mix) - Radar Detector
TheBietz - Zilleq
Summer Breeze - Activator
さくらさくら ～ Japanize Dream... - 彩音 ~xi-on~
Utopia - Elliot Hsu
Complexity - MadEye
Showtime (Original Mix) - Henry Himself
Time To Love - October
영혼의 노래 - July
Imagine (Original Mix) - MaHi
Shine - Canvai
Vigilante - Dave Erpson
Froz3n - Sound Rush
봄의 태양 - July
Emeralds - CelDro
China-P - 徐梦圆
Queen of the Red - ETIA.
나를 위한 여행 - January
Return (Aroze Violin Remix) - Aroze / Axel Wernberg / Linne / Ennex
On The Road - TFLM / Dave Erpson
The truth that you leave - Pianoboy高至豪
낙엽소리 - July
Lifeline - Zeraphym 六翼使徒
Drop the Beat (VIP Mix) - DJ Kuba / Neitan / Nicci
Summer Vibes - Elektronomia
Crystalline - CircusP / GUMI
Coming Home - Brennan Heart / Audiotricz / CHRISTON
Forever - Neilio / Melissa Pixal
Hands Up High (Original Mix) - Faizar
Swing - L3V3LS
Don Coi (Instrumental) - Truong Quynh Anh
Tomorrow With You - Senpai / Kondor
Gold Dust (Envine Bootleg) - Galantis / Envine
Dreams (Original Mix) - Axlance / Luka Krajina
The Garden of Escapism (AK Remix) - AK / Miro
Mystic Tides - FEWZ
Letter - iris
China-X - 徐梦圆
Elevation (Club Mix) - Ecstatic
Oceano - Zeus
Northern Skies (Original Mix) - Zero Venture
Shades Of Grey (DFLV Remix) - DFLV / Oliver Heldens / Shaun Frank / Delaney Jane
One Shot (Original Mix) - Dirty Palm
Blow This Club - Max Vangeli / Flatdisk
Radioactive - William Joseph
Piano Beat - BeaTsGOy
Broken Ones Ft. Sundstroem (Original Mix) - Duact
Our Journey - CelDro / Kantilo
I Won't Let You Walk Away (Lost Kings Remix) - Mako / Madison Beer
Within (Original Mix) - OceansWhoLied
Heartmelt Part II (inst.) - Elyon Beats
Shrine of Light - Andreas B.
Without You (Radio Version) - Refuzion
Cold Winter - July
Whatever - 徐梦圆
Bowser(Gurun Mashup) - W&W / Blasterjaxx / Calvin Harris / DjGurun
Get Ready! (Blasterjaxx Edit) - Blasterjaxx / BOOSTEDKIDS
Freaks (W&W Bigroom Edit) - W&W / Timmy Trumpet / Savage
Knightlife (Extended Mix) - Riggi & Piros
Jump - Wolfpack / BOBBY PUMA
Kernkraft 400 (W&W Remix) - Zombie Nation
Kaya - DallasK
Flamme - John Dish / Ale Mora
Guess Who's Back - Sidney Samson / Gwise
Ragged (Extended Mix) - Jordy Dazz / BLOQSHOT
Into The Light (Extended Mix) - Sick Individuals / DBSTF
Rocket Spaceman (W&W & Hardwell Closing Edit) - W&W / Blasterjaxx / Hardwell
Spaceman - Hardwell
Spaceman (Chris JEG Remix) - Chris JEG / Hardwell
Raptor (Quintino Edit) - Quintino / Robert Falcon
Burden of Life - Rameses B
Like Thiz - Taito
Bromance - Ennex / Pilton
Another Day - DJ Siesta
Sonder - Sylence
Adventure - Spektrel
Reality (Original Edit) - Rebourne / Neilio
Nature's Gasp (Radio Edit) - Atmozfears / Devin Wild
Refrain - 阿南亮子
A Little Story - Valentin
Stories - Kedam
Pearlescent - EnV
On A Hill - L3V3LS
Alive - Jordan Kelvin James
Daydreams (Original Mix) - Valcos
Chaoz Fantasy (Romos Remix) - romos / ParagonX9
Just Smile (Original Mix) - Spaarkey
Cloud 9 - Tobu / Itro
Bubble Bath - Kev
Time (Official) - MKJ
Only Wish - Nicholas Cheung
Beautiful Star - Sizzle Bird
Where Is the Love - Josh Vietti
plasma (2015 rework) - kamome sano
Zippo - Chasjam
Falling - AndyM
The Moments We Shared...I Miss Them - Jacoo
One Day (Original Mix) - Antrux
Sparks - Elektronomia
S.K.Y.Prox - Hoaprox
Guitar Track (Kayliox Remix) - Kayliox
Nevermind - Wisp X
Dreaming - Pilton
Hero - SmK
Same Skies (Original Mix) - Refined
Rocket (Original Mix) - W&W / Blasterjaxx
Rocket (Lookas Remix) - W&W / Blasterjaxx / Lookas
Shatter - Feint
Luminescent - Sparkle
Clouds (Version 2) - TomLeevis
Here We Go (Original Edit) - Klaas / Mazza
The #IcePack Rises (Original Mix) - EnV
Find the Light - Audalanche
Luv Letter - DJ Okawari
Flower Dance - DJ Okawari
Zeemeeuw - Lindequist
Good Time (Radio Edit) - Flava & Stevenson
Dear Past (Original Mix) - Sphericz
Old Skool (Nitro Fun Remix) - Televisor / Nitro Fun
Miracle In The Middle Of My Heart (Original Mix) - Clément Bcx
Summer (Klaas Remix) - Mazza / Klaas
Luv Letter (Wisp X Remix) - Wisp X / DJ Okawari
Again (Skyvoice Cover/Remix) - Skyvoice / no-no
I Choose U - Timeflies
Sky (Radio Edit) - Steerner / Martell
Angel ( Radio Edit ) - Dogena
Hibiscus - Wisp X
Astronomia 2014 (Radio Edit) - Vicetone / Tony Igy
Times - Itro
Göteborg (Original Mix) - Sundholm / OLWIK
Leviathan (Original Mix) - KSHMR
Shotgun Senorita - Blue Stahli
Highflier - Teminite
Solstice - K-391
Sitting Next To You - Mokoa
One Wish - Tanaki Alison
Levitate - FEWZ
Falling Or Fallen (Original Mix) - James Egbert
Luminescent - Skyvoice / Sparkle
Adventures - Starix​
Anesthesia - Vexento
Forgive Me - CMA
Proxy - Martin Garrix
Don't Look Down - Martin Garrix / Usher
Smash! (Original Mix) - Ummet Ozcan
Am I Wrong (Win & Woo Remix) - Win & Woo / Nico & Vinz
The Top (Original Mix) - TomLeevis
Boss Mode - Knife Party / Raja Kumari
Witch Dance - Stive Morgan
Happy - Dogena
Derp - Bassjackers / MAKJ
Don't Stop (TheFatRat Remix) - Foster The People
Dusk (Original Mix) - Axero
Evolution - Teminite
Xenogenesis - TheFatRat
Heaven - Lensko
Heist - Noisestorm
Booyah - Showtek / We Are Loud / Sonn Wilson
Run Wild (Extended Mix) - Hardwell / Jake Reese
Freak (VIP Remix) - R3HAB / Quintino
No Flex Zone (Instant Party! Remix) - Instant Party! / Rae Sremmurd
How We Party - R3HAB / Vinai
Rave After Rave (Original Mix) - W&W
Bunnydance - Oliver Heldens
Cake Face - Steve Aoki
Clap Your Hands - David Guetta / Glowinthedark
Rocky(Kaaze's Extended Mix) - Tiësto / KAAZE
Poison - Martin Garrix
Musicbox (Original Mix) - Hardwell / Martin Garrix
Louder (Extended Mix) - Dimitri Vegas & Like Mike / Vinai
Master Of Tides - Lindsey Stirling
Forever - Ahxello
Daylight (Extended Mix) - Yves V / Dimitri Vangelis & Wyman
Lights Out (Extended Mix) - Dannic / AMERSY
Rest (Original Mix) - Zeraphym 六翼使徒
Listen - Said The Sky
Tremble (Original Mix) - Vicetone
Inspire - Throttle
Left Behind - Ahrix
Mario - JJD
Run Away - Fareoh
Floating [Original Mix(Krewella's Alive Vocal)] - Tobu / Krewella
13 Months - Raven / Kleekamp
Soaring (Original Mix) - TomLeevis
DJ Jackson 14minute Live Remixes - jackson
Don't Stop (TheFatRat Remix) - TheFatRat / Foster The People
Too Original (TJR Remix) - TJR / Major Lazer / Elliphant / Jovi Rockwell
Silver Lining - CelDro
Drop That Low (When I Dip) [Extended Mix] - Tujamo
Ethereal - JJD
Morning Energy - Tobu
Portilla De Bobo (Radio Edit) - F.Y.I. / Minelli
Skies - Dogena / Axel Wernberg
Disconnected - Pegboard Nerds
Invincible - DEAF KEV
Regrets (Too Late) - Zeraphym 六翼使徒
Sandstorm (Didrick Remix) - Darude / Didrick
Ninja Challenge(Dodge & Fuski Remix) - Eptic / Habstrakt / Dodge & Fuski
Melody (Extended Mix) - Dimitri Vegas & Like Mike / Steve Aoki / Ummet Ozcan
We Wanna Party (VIP Edit) - TJR / Savage
Skyline - Ryan Farish
Dennis - Alan Walker
Eternity (Original Mix) - CYH / Visioc
Stay (Vhana Remix) - Vhana
Machine (Original Mix) - Fenk
Struggle (Original Mix) - Axero
Temptations (Ben Delaney Rework) - Ben Delaney / Lister
The Spook - KSHMR / BassKillers / B3nte
We Are One - Vexento
Infinite Love - Young London
Visions - Acreix
Pop Danthology 2012 - DJ Daniel Kim
Forgettable - Project 46 / Olivia
Keep Shining (VINAI Remix) - Redfoo / Vinai
Gotham (Original Mix) - Kura / Mike Hertz
Wrong Answer (Original Mix) - Rob Gasser
Lights Out (Will Sparks & Joel Fletcher Remix) - Will Sparks / Joel Fletcher / 360
Tick Tock (Original Mix) - Deorro / Riggi & Piros
Leave It Behind (feat. 12th Planet & Ash Riser) - Virtual Riot / Ash Riser / 12th Planet
Showdown (feat. ShockOne) - Virtual Riot / ShockOne
Juices (feat. Dubloadz) - Virtual Riot / Dubloadz
Borg (feat. FuntCase) - Virtual Riot / FuntCase
Beloved Tomboyish Daughter (NGC 3​.​14 Remix) - NGC 3.14
The Wave (Nick Blasian Bootleg) - Nick Blasian / Vinai
Ice Cream - OMFG
The New Kings - Vicetone / Popeska / Luciana
Triumph - WRLD
Stars - Ahxello
Silver City - MYRNE / Linying
Frontier (Extended Mix) - Vinai / SCNDL
Stay With Me Always (Innocence) - Zeraphym 六翼使徒
Entropy - Alex Skrindo / Distrion
Shots (Broiler Remix) - Broiler / Imagine Dragons
Ringtone (MetroGnome Remix) - MetroGnome
Mystica (Original Mix) - Blasterjaxx
Titan - Blasterjaxx / Badd Dimes
Jumper (Original Mix) - W&W / Hardwell
Savior (Original Mix) - Bassjackers
Burn (Original Mix) - KSHMR / DallasK
Devotion - Quintino
Mayday - Ralvero
Slammer - Quintino / FTampa
Wild (Henry Fong Remix) - Snails / Antiserum / Henry Fong
Funk With Me - Snails / Big Gigantic
Get Low - DJ Snake / Dillon Francis
Set Yourself Free - Tiësto / Krewella
If I Lose Myself (Alesso Vs. Onerepublic Extended Remix) - Alesso / OneRepublic
Coffins - Pegboard Nerds / MisterWives
My Sunset (Original Mix) - Feint
Here It Comes - Pegboard Nerds
Lights Out - Zomboy
鲤 - igoo2u
Summer Ashes (VIP) - Kevin Drew / Taryn Manning
Let's Get F**ked Up - MAKJ / Lil Jon
READY! (Original Mix) - Deorro / MAKJ
Tenko - Oorora
High Above - Starix
Autumn - Kozoro
135 - Alan Walker
Break Again (Original Mix) - Jack Howes / Jade Leigh
Ascent - Teminite
Aspire - CelDro
Return Of The Raver - Vexento
Virtual World - SmK
Stand With Me - Wisp X
River Flows In You (Original Mix) - Mark Pride
Fly Away (JPB Remix) - Krys Talk / JPB
Lightbringer - Far Too Loud
Symphonica (Original Mix) - Nicky Romero
The Quick and the Dead (Original Mix) - Rudebrat
Moonlight - Rameses B
Boss Wave - Xilent
Blossom - Au5
Radiate - Panda Eyes
**** off - Panda Eyes
On My Own - Panda Eyes
95K - Panda Eyes
Crystal Cave - Panda Eyes
Euphoria - Panda Eyes
ILY - Panda Eyes
Drippy Dub - Panda Eyes
Crowd Control - Downlink
Endeavors (Original Mix) - MitiS
Silver Scrapes - 英雄联盟 / Danny McCarthy
Come And Get It (Razihel Remix) - Krewella / Razihel
Running Away[NCS Release] - Tobu / Marcus Mouya
Vibrance - Wisp X
Escape - Dripice
I Love You - OMFG / MILLAN
Journey - Elektronomia / Stahl!
Flashlight - R3HAB / Deorro
What You're Waiting For - Tiësto / Ummet Ozcan
Summit - Skrillex / Ellie Goulding
Open Window (Original Mix) - MitiS / Anna Yvette
Higher - Tobu
Levels (Radio Edit) - Avicii
**** Gravity - Virtual Riot
Blu (Original Mix) - MitiS / MaHi
Hope - Ahxello
Life - Steerner / Gson & Abley
Seven - Tobu
Horizon (Radio Edit) - Steerner / Kavela / Matthew Steeper
Reflection - Tobu
Dreaming - Kozoro / Evence
Pump It Up - Panda Eyes
Heartbit (12th Planet Remix) - Pegboard Nerds / 12th Planet / Tia Simone
Levitate - Ahxello
Tomorrow - Ahxello
Unity - Dirty Dropouts / Aloma Steele
Light Speed - Ahxello
Courage - Ahrix
Ex Machina (Original Mix) - Tryple / Extra Terra
Blue Sky - Feenixpawl / Mary Jane Smith
Panic (Skyloud Remix) - Skyloud / Phantom Sage / Detrace
FireFrost - EnV
Get Mad - Rob Gasser
Yet So Close - Vexento
Blank - Disfigure
Infinity - Axel Wernberg
Jumbo - Alex Skrindo
World Summit (Original Mix) - Modulation
Power-Up - Electric Joy Ride
Here We Are - Laszlo
The Copycat - Rob Gasser
Rising - Lumious
Come With Me - Anna Yvette / Nitro Fun / Subtact
True Colors - SmK
Skype Track  (Original Mix) - Andreas B.
Mashed Potatoes - OMFG
Fire Away (Virtual Riot Remix) - Virtual Riot / Skrillex
Satellites - Nyte
Tonight (Ole Botten & Adium Remix) - Axero / Ole Botten / Adium
Over the Horizon - TomLeevis
Firefly - Jim Yosef
Dawn - Janji
Future Funk - Varien
If Only You - Drop Tower
Endless - Natio
Boneless - Steve Aoki / Chris Lake / Tujamo
The Power of Now - Steve Aoki / Headhunterz
Ascension (Remix) - MitiS / Dope Arcade
Calavera (Extended Mix) - Hardwell / Kura
Ragga Bomb (Skrillex & Zomboy Remix) - Skrillex / Ragga Twins / Zomboy
First Of The Year - Skrillex
Kyoto - Skrillex / Sirah
Dirty Vibe (with Diplo, G-Dragon, and CL) - Skrillex
Monody - TheFatRat / Laura Brehm
Infinity - Ahxello
Trip - Axero
Idols (EDM Mashup) - Virtual Riot
Survive - Virtual Riot
Sugar Rush - Virtual Riot
Energy Drink - Virtual Riot
EuroDancer - Klave
Emotional (Virtual Riot Remix) - Virtual Riot / Flux Pavilion / Matthew Koma
Waves - Steerner
Unity - Axero
Face Down (Original Mix) - Feint
Vagrant - Feint / Veela
Ripples - Alex Skrindo
River - Axero
Sky High - Ahxello
Witness (Instrumental) - Approaching Nirvana
Ark (Original Mix) - Rob Gasser / Raider
Alkaline - Funxion
Ease (Alex Skrindo - Ease) - Alex Skrindo
Yeah - OMFG
Masked Heroes - Vexento
305 - Approaching Nirvana
Five Hours - Deorro
Es rappelt im Karton - Pixie Paris
Windfall - TheFatRat
Crystals - Steerner / Martell
Hello - OMFG
Unity - TheFatRat
My Heart - EH!DE / Different Heaven
Green Sky - Alex Skrindo
Firestorm - Far Too Loud
Power Glove - Knife Party
Spectre - Alan Walker
Bangarang - Skrillex / Sirah
Fade - Alan Walker
Adventures - Alex Skrindo
Emotions - Verdial / Alex Skrindo
Alive - Alex Skrindo
Downtown - Axero
Move - Axero / Itro
Sun - Steerner / Martell
Nova - Ahrix
Blu - MitiS / MaHi
Natural - Axero
Friends - Steerner
Horizon - Janji
Home - Itro
Flight - Tristam / Braken
Waves - Axero
The Silent Majority - Vexare

